ack.vim/ - * master origin	git@github.com:mileszs/ack.vim.git (fetch)
bclose.vim/ - * master origin	git@github.com:rbgrouleff/bclose.vim.git (fetch)
elm.vim/ - * master origin	git@github.com:lambdatoast/elm.vim.git (fetch)
ensime-vim/ - * master origin	git@github.com:ensime/ensime-vim.git (fetch)
fzf/ - * master origin	git@github.com:junegunn/fzf (fetch)
idris-vim/ - * master origin	git@github.com:idris-hackers/idris-vim.git (fetch)
nerdtree/ - * master origin	git@github.com:scrooloose/nerdtree.git (fetch)
syntastic/ - * master origin	git@github.com:scrooloose/syntastic (fetch)
tabular/ - * master origin	git://github.com/godlygeek/tabular.git (fetch)
tcomment_vim/ - * master origin	git@github.com:tomtom/tcomment_vim.git (fetch)
vim-airline/ - * master origin	git@github.com:vim-airline/vim-airline (fetch)
vim-airline-themes/ - * master origin	git@github.com:vim-airline/vim-airline-themes (fetch)
vim-colors-off/ - * master origin	git@github.com:d6y/vim-colors-off.git (fetch)
vim-colors-pencil/ - * master origin	git@github.com:reedes/vim-colors-pencil.git (fetch)
vim-colors-solarized/ - * master origin	git@github.com:altercation/vim-colors-solarized.git (fetch)
vim-fugitive/ - * master origin	git@github.com:tpope/vim-fugitive.git (fetch)
vim-gitgutter/ - * master origin	git@github.com:airblade/vim-gitgutter.git (fetch)
vim-go/ - * (HEAD detached at v1.6)
  master origin	git@github.com:fatih/vim-go.git (fetch)
vim-multiple-cursors/ - * master origin	git@github.com:terryma/vim-multiple-cursors.git (fetch)
vim-pencil/ - * master origin	git@github.com:reedes/vim-pencil.git (fetch)
vim-repeat/ - * master origin	git@github.com:tpope/vim-repeat.git (fetch)
vim-sbt-quickfix/ -  
vim-scala/ - * master origin	git@github.com:derekwyatt/vim-scala.git (fetch)
vim-signature/ - * master origin	git@github.com:kshenoy/vim-signature.git (fetch)
vim-surround/ - * master origin	git://github.com/tpope/vim-surround.git (fetch)
